"------------------------------ -"
"-                 -          - -"
"-                 -          - -"
"-                 -          - -"
"-            ----------------- -"
"-                            - -"
"-                            - -"
"-                            - -"
"-----                        - -"
"------                       - -"
"-------                      - -"
"----------    ---------------- -"
"-                            - -"
"-                            - -"
"-                            - -"
"-                            - -"
"-     -----------------      - -"
"-         -     -            - -"
"-         -     -            - -"
"-         -     -            - -"
"-         -           ----------"
"-         -          ---        "
"-         -         ----        "
"------------------------        "