"-------------------------"
"-                       -"
"-                       -"
"-                       -"
"-            --         -"
"-                       -"
"--                      -"
"-                       -"
"-                   --- -"
"-                       -"
"-                       -"
"-      ---              -"
"-                       -"
"-   -----------         -"
"-                       -"
"-                -      -"
"-                   --  -"
"-                       -"
"-                       -"
"-------------------------"