"--------------------------------"
"-                 -          ---"
"-                 -     x    ---"
"-                 -          ---"
"-            -------------------"
"-                            ---"
"-                            ---"
"-                            ---"
"-----                        ---"
"------                       ---"
"-------                      ---"
"----------    ------------------"
"- x                          ---"
"-                            ---"
"-                            ---"
"-                            ---"
"-     -----------------      ---"
"-         -     -            ---"
"-         -     -            ---"
"-         -     -            ---"
"-         -           ----------"
"-         -          -----------"
"-         -         ------------"
"--------------------------------"