"--------------------------------"
"-                              -"
"-                              -"
"-                              -"
"-            --                -"
"-                              -"
"--                             -"
"-                              -"
"-                   ---        -"
"-                              -"
"-                              -"
"-      ---                     -"
"-                              -"
"-   -----------                -"
"-                              -"
"-                -             -"
"-                   --         -"
"-                              -"
"-                              -"
"-                              -"
"-                      ---------"
"-                      -        "
"-                      -        "
"------------------------        "