"--------------------------------"
"-                            ---"
"-                            ---"
"-                            ---"
"-               ----     -------"
"-                            ---"
"-                            ---"
"-    ---                     ---"
"-----         ---            ---"
"-                            ---"
"-                            ---"
"-                       --------"
"-                            ---"
"-                            ---"
"-            --              ---"
"-           ----             ---"
"-     -----------------      ---"
"-                            ---"
"-                            ---"
"-                            ---"
"-                      ---------"
"-         -            ---------"
"-        ---           ---------"
"--------------------------------"