"--------------------------------"
"-                            ---"
"-                            ---"
"-      xx                    ---"
"-               ----     -------"
"-                            ---"
"-                            ---"
"-    ---                     ---"
"-----         ---       x    ---"
"-                            ---"
"-                            ---"
"-                       --------"
"-                            ---"
"-                            ---"
"-            --              ---"
"-           ----             ---"
"-     -----------------      ---"
"-                            ---"
"-                            ---"
"-                            ---"
"-                      ---------"
"-         -            ---------"
"- x      ---           ---------"
"--------------------------------"