"--------------------------------"
"-                 -          ---"
"-                 -          ---"
"-               x -          ---"
"-            ---------   -------"
"-                            ---"
"---                          ---"
"-                            ---"
"-             x              ---"
"-                            ---"
"-                            ---"
"--------      ----        ------"
"-                            ---"
"-                            ---"
"-                            ---"
"-                            ---"
"-     ------      --         ---"
"-         -  x  -            ---"
"-         -     -            ---"
"--              -            ---"
"--                      --------"
"----                   ---------"
"------              ------------"
"--------------------------------"